FE7 - Fields - 1c1d1e1f
10 15
67 132 67 107 163 133 395 67 99 142 103 720 851 852 853
785 783 66 198 199 67 292 390 132 102 80 782 883 884 885
162 99 198 433 401 199 130 132 268 203 107 868 915 916 917
79 45 300 294 401 316 263 262 295 235 70 167 204 433 433
6 71 848 133 230 247 246 231 131 66 46 99 264 177 295
102 103 782 99 66 21 24 131 132 76 137 388 301 67 66
67 198 199 66 67 131 164 131 836 131 46 163 131 162 67
130 230 401 205 784 133 684 228 771 132 720 98 198 199 132
199 165 144 201 100 99 99 720 131 674 132 132 360 301 131
305 145 295 301 720 99 198 199 720 99 782 70 41 67 100
